{
  "groundTextureUrl": "./assets/textures/ground.jpg",
  "wallTextureUrl": "./assets/textures/wall.jpg",
  "doorTextureUrl": "./assets/textures/ground.jpg",
  "elevatorTextureUrl": "./assets/textures/ground.jpg",
  "size": { "width": 12, "height": 20 },
  "map": [
    [3, 2, 3, 2, 2, 2, 2, 2, 2, 2, 2, 2, 1],
    [1, 0, 6, 0, 0, 0, 0, 0, 0, 0, 0, 0, 1],
    [3, 2, 1, 0, 0, 0, 3, 2, 2, 2, 4, 2, 1],
    [1, 0, 1, 0, 0, 0, 1, 0, 0, 0, 0, 0, 1],
    [1, 0, 5, 0, 0, 0, 1, 0, 0, 0, 0, 0, 1],
    [3, 2, 2, 2, 1, 0, 3, 2, 2, 2, 2, 2, 1],
    [1, 0, 0, 0, 1, 0, 5, 0, 0, 0, 0, 0, 1],
    [1, 0, 0, 0, 1, 0, 1, 0, 0, 0, 0, 0, 1],
    [1, 0, 0, 0, 1, 0, 1, 0, 0, 0, 0, 0, 1],
    [1, 0, 0, 0, 1, 0, 1, 0, 0, 0, 0, 0, 1],
    [1, 0, 0, 0, 5, 0, 1, 0, 0, 0, 0, 0, 1],
    [1, 0, 0, 0, 1, 0, 3, 2, 2, 2, 2, 2, 1],
    [3, 2, 2, 2, 1, 0, 5, 0, 0, 0, 0, 0, 1],
    [1, 0, 0, 0, 1, 0, 1, 0, 0, 0, 0, 0, 1],
    [1, 0, 0, 0, 1, 0, 3, 2, 2, 2, 2, 2, 1],
    [1, 0, 0, 0, 5, 0, 1, 0, 0, 0, 0, 0, 1],
    [1, 0, 0, 0, 1, 0, 1, 0, 0, 0, 0, 0, 1],
    [1, 0, 0, 0, 1, 0, 1, 0, 0, 0, 0, 0, 1],
    [1, 0, 0, 0, 1, 0, 5, 0, 0, 0, 0, 0, 1],
    [1, 0, 0, 0, 1, 0, 1, 0, 0, 0, 0, 0, 1],
    [2, 2, 2, 2, 2, 2, 2, 2, 2, 2, 2, 2, 0]
  ],
  "initialPosition": [5, 3],
  "initialDirection": 0.0,
  "exitLocation": [-0.5, 6]
}
