{
  "groundTextureUrl": "./assets/textures/ground.jpg",
  "wallTextureUrl": "./assets/textures/wall.jpg",
  "doorTextureUrl": "./assets/textures/ground.jpg",
  "elevatorTextureUrl": "./assets/textures/ground.jpg",
  "size": { "width": 12, "height": 20 },
  "map": [
    [3, 2, 2, 2, 3, 2, 3, 2, 2, 2, 2, 2, 1],
    [1, 0, 0, 0, 5, 0, 1, 0, 0, 0, 0, 0, 1],
    [1, 0, 0, 0, 1, 0, 1, 0, 0, 0, 0, 0, 1],
    [1, 0, 0, 0, 1, 0, 1, 0, 0, 0, 0, 0, 1],
    [3, 2, 2, 2, 1, 0, 2, 4, 2, 2, 2, 2, 1],
    [1, 0, 0, 0, 5, 0, 0, 0, 0, 0, 0, 0, 1],
    [1, 0, 0, 0, 3, 2, 2, 2, 2, 2, 1, 0, 1],
    [1, 0, 0, 0, 1, 0, 0, 0, 0, 0, 1, 0, 1],
    [3, 2, 2, 2, 1, 0, 0, 0, 0, 0, 1, 0, 1],
    [1, 0, 0, 0, 1, 0, 0, 0, 0, 0, 1, 0, 1],
    [1, 0, 0, 0, 2, 2, 2, 2, 4, 2, 0, 0, 1],
    [1, 0, 0, 0, 1, 0, 0, 0, 0, 0, 0, 0, 1],
    [3, 2, 3, 2, 0, 0, 0, 0, 3, 4, 2, 2, 1],
    [1, 0, 6, 0, 0, 0, 0, 0, 1, 0, 0, 0, 1],
    [3, 2, 0, 0, 3, 2, 4, 2, 1, 0, 0, 0, 1],
    [8, 0, 0, 0, 1, 0, 0, 0, 1, 0, 0, 0, 1],
    [3, 2, 4, 2, 1, 0, 0, 0, 1, 0, 0, 0, 1],
    [1, 0, 0, 0, 1, 0, 0, 0, 1, 0, 0, 0, 1],
    [1, 0, 0, 0, 1, 0, 0, 0, 1, 0, 0, 0, 1],
    [1, 0, 0, 0, 1, 0, 0, 0, 1, 0, 0, 0, 1],
    [2, 2, 2, 2, 2, 2, 2, 2, 2, 2, 2, 2, 0]
  ],
  "initialPosition": [4, 3],
  "initialDirection": 0.0,
  "exitLocation": [5, 3]
}
